16
..@......@..@@@.
@...@@@...@.@...
@........@...@@@
..@..@@......@..
......@@...@..@.
@......@..@...@@
@.........@@..@.
@@....@@.@.@....
........@...@..@
@..@@..........@
@...@.@...@.@...
@.@.........@.@@
.@@.....@.@.....
@...@...@....@..
@@..@....@..@@@@
.....@..@....@..
