8
@@@@@@@@
@...@..@
@...@...
@...@..@
@@..@@@@
@@...@@.
@@......
@@..@@..
